2222222222222222222222222222222222222222222222222222222
1000000000000000000000000000000000000000000000000000001
1000000000000000000000000000000000000000000000000000001
1000000000000000000000000000000000000000000000000000001
1000000002220000000000000000000000000022200000000000001
1000000002100000000000000000000000000001200000000000001
1000000002220000000000000000000000000022200000000000001
1000000002100000000000000000000000000001200000000000001
1000000002220000000000000000000000000022200000000000001
1000000002100000000000000000000000000001200000000000001
1000000002220000000000000000000000000022200000000000001
1000000002100000000000000000000000000001200000000000001
1000000002220000000000000000000000000022200000000000001
1000000002100000000000000000000000000001200000000000001
1000000002220000000000000000000000000022200000000000001
1000000002100000000000000000000000000001200000000000001
1000000002220000000000000000000000000022200000000000001
1000000002100000000000000000000000000001200000000000001
1000000002220000000000000000000000000022200000000000001
1000000002100000000000000000000000000001200000000000001
1000000002220000000000000000000000000022200000000000001
1000000000000000000000000000000000000000000000000000001
1000000000000000000000000000000000000000000000000000001
1000000000000000000000000000000000000000000000000003001
2222222222222222222222222222222222222222222222222222222