2111111111111111111111111111111111111111111111111111112
2000000000000000000000000000000000000000000000000000002
2000000000000000000000000000000000000000000000000000002
2000000000000000000000000000000000000000000000000000002
2000000000000000000000000000000000000000000000000000002
2000000000000000000000000000000000000000000000000000002
2000000000000022222222222222222222222222222220000000002
2000000000000022122212221221221221222122212220000000002
2000000000000022022202220220220220222022202220000000002
2000000000000000000000000000000000000000000000000000002
2000000000000000000000000000000000000000000000000000002
2000000000000000000000000000000000000000000000000000002
2000000000000000000000000000000000000000000000000000002
2000000000000000000000000000000000000000000000000000002
2000000000000000000000000000000000000000000000000000002
2000000000000000000000000000000000000000000000000000002
2000000000000022022202220220220220222022202220000000002
2000000000000022122212221221221221222122212220000000002
2000000000000022222222222222222222222222222220000000002
2000000000000000000000000000000000000000000000000000002
2000000000000000000000000000000000000000000000000000002
2000000000000000000000000000000000000000000000000000002
2000000000000000000000000000000000000000000000000000002
2000000000000000000000000000000000000000000000000003001
2111111111111111111111111111111111111111111111111111112