1111111111111111111111111111111111111111111111111111112
2000000000000000000000000000000000000000000000000000002
2000000000000000000000000000000000000000000000000000002
2000000000000000000000000000000000000000000000000000002
2000000001110000000000000000000000000011100000000000002
2000000001100000000000000000000000000001200000000000002
2000000001110000000000000000000000000011100000000000002
2000000001100000000000000000000000000001200000000000002
2000000001110000000000000000000000000011100000000000002
2000000001100000000000000000000000000001200000000000002
2000000001110000000000000000000000000011100000000000002
2000000001100000000000000000000000000001200000000000002
2000000001110000000000000000000000000011100000000000002
2000000001100000000000000000000000000001200000000000002
2000000001110000000000000000000000000011100000000000002
2000000001100000000000000000000000000001200000000000002
2000000001110000000000000000000000000011100000000000002
2000000001100000000000000000000000000001200000000000002
2000000001110000000000000000000000000011100000000000002
2000000001100000000000000000000000000001200000000000002
2000000001110000000000000000000000000011100000000000002
2000000000000000000000000000000000000000000000000000002
2000000000000000000000000000000000000000000000000000002
2000000000000000000000000000000000000000000000000003002
1111111111111111111111111111111111111111111111111111112