2111111111111111111111111111111111111111111111111111112
1000000000000000000000000000000000000000000000000000001
1000000000000000000000000001000000000000000000000000001
1000000000000000000000000001000000000000000000000000001
1000000000000000000000000001000000000000000000000000001
1000000000000000000000000001000000000000000000000000001
1000000000000000000000000001000000000000000000000000001
1000000000000000000000000001000000000000000000000000001
1000000000000000000000000001000000000000000000000000001
1000000000000000000000000001000000000000000000000000001
1000000000000000000000000001000000000000000000000000001
1000000000000000000000000001000000000000000000000000001
1000000000000000000000000001000000000000000000000000001
1000000000000000000000000001000000000000000000000000001
1000000000000000000000000001000000000000000000000000001
1000000000000000000000000001000000000000000000000000001
1000000000000000000000000001000000000000000000000000001
1000000000000000000000000001000000000000000000000000001
1000000000000000000000000001000000000000000000000000001
1000000000000000000000000001000000000000000000000000001
1000000000000000000000000001000000000000000000000000001
1000000000000000000000000001000000000000000000000000001
1000000000000000000000000001000000000000000000000000001
1000000000000000000000000000000000000000000000000003001
2111111111111111111111111111111111111111111111111111112